20 7 7 7 7 7 7 7 7 7 7 7 7 7 7 7 7 7 7 7 7 7 7 7 7 7 7 7 7 7 7 7 7 7 7 7 7 7 7 7 7 7 7 7 7 7 7 7 7 21
11 0 0 0 0 0 1 0 0 0 0 0 0 0 0 0 0 0 0 0 0 0 1 0 0 0 0 0 0 0 0 0 0 0 0 0 0 0 0 0 0 0 0 0 0 0 0 0 0 10
11 0 0 1 0 0 0 0 0 0 0 0 0 0 0 0 0 0 0 0 0 0 0 0 0 0 0 0 0 1 0 0 0 0 0 0 0 0 0 0 0 1 0 0 0 0 0 0 0 10
11 0 0 0 0 0 0 0 0 0 0 3 3 3 3 3 3 3 0 0 0 3 3 3 3 3 3 3 0 0 0 3 3 3 3 3 3 3 0 0 0 0 0 0 0 1 0 0 0 10
11 0 0 4 0 0 0 0 0 0 0 3 5 5 5 5 5 3 0 0 0 3 5 5 5 5 5 3 0 0 0 3 5 5 5 5 5 3 0 1 0 0 0 0 0 0 4 0 0 10
11 0 0 0 0 0 0 0 0 1 0 3 5 5 5 5 5 3 1 0 0 3 5 5 5 5 5 3 0 0 0 3 5 5 5 5 5 3 0 0 0 4 0 0 0 0 0 0 0 10
11 0 0 1 0 4 0 0 1 0 0 3 5 5 5 5 5 3 0 0 0 3 5 5 5 5 5 3 0 1 0 3 5 5 5 5 5 3 0 0 0 0 0 0 0 0 1 0 0 10
11 0 0 0 0 0 0 0 0 1 0 3 5 5 5 5 5 3 0 1 0 3 5 5 5 5 5 3 0 0 0 3 5 5 5 5 5 3 0 0 0 0 0 1 0 0 0 0 0 10
11 0 4 0 0 1 0 0 0 0 0 3 5 5 5 5 5 3 0 0 0 3 5 5 5 5 5 3 0 0 0 3 5 5 5 5 5 3 0 0 0 1 0 0 0 0 1 0 0 10
11 0 0 0 0 0 0 0 0 0 0 3 3 3 5 3 3 3 0 0 0 3 3 3 5 3 3 3 0 1 0 3 3 3 5 3 3 3 0 0 0 0 0 0 0 0 0 1 0 10
11 0 0 1 0 4 0 0 0 0 0 0 0 0 5 0 0 0 0 0 0 0 0 0 5 0 0 0 0 0 0 0 0 0 5 0 0 0 0 0 1 0 0 4 0 0 0 0 0 10
11 0 0 0 0 0 0 1 0 0 1 0 0 0 5 5 5 5 5 5 5 5 5 5 5 5 5 5 5 5 5 5 5 5 5 0 0 0 0 0 0 0 0 0 0 1 0 0 0 10
11 0 0 0 0 4 0 0 0 0 0 0 0 0 1 0 0 0 0 0 0 0 0 0 0 0 0 0 0 0 0 0 0 0 0 0 0 0 0 0 0 0 1 0 0 0 0 0 0 10
11 0 1 0 0 0 0 0 0 0 1 0 0 0 0 1 0 0 0 1 0 0 0 0 0 0 0 0 0 0 0 1 0 0 0 0 0 1 0 0 0 0 0 0 0 0 0 0 1 10
11 0 0 1 0 1 0 0 0 0 0 0 0 0 0 0 0 0 0 0 13 12 12 12 12 12 12 12 14 0 0 0 0 0 0 0 0 0 0 0 1 0 0 1 0 0 0 0 0 10
11 1 0 0 0 0 1 0 0 1 0 0 0 0 1 0 0 0 0 0 10 2 2 2 2 2 2 2 11 0 0 0 0 4 0 0 0 0 0 0 0 0 0 0 0 0 0 0 0 10
11 0 0 1 0 1 0 0 0 0 0 0 0 0 0 0 0 0 1 0 10 2 2 19 2 19 2 2 11 0 0 0 0 0 0 0 0 0 1 0 0 0 0 0 1 0 0 0 0 10
11 0 0 0 0 0 0 0 0 0 0 1 0 0 0 4 0 0 0 0 10 2 2 2 2 2 2 2 11 0 0 0 0 0 0 1 0 0 0 0 0 1 0 0 0 0 0 0 0 10
11 0 1 0 0 0 0 4 0 0 0 0 0 0 0 0 0 0 0 0 10 2 2 15 16 19 2 2 11 0 0 0 0 0 0 0 0 0 0 0 0 0 0 1 0 0 0 0 0 10
11 0 0 0 1 0 0 0 0 0 0 0 1 0 0 0 1 0 0 0 10 2 2 17 18 2 19 2 11 0 0 0 0 0 0 0 0 4 0 0 0 1 0 0 0 0 0 0 0 10
11 0 0 0 0 0 0 1 0 0 0 0 0 0 0 0 0 0 0 0 10 2 2 19 2 15 16 19 11 0 0 0 0 0 0 0 0 0 0 0 0 0 0 0 1 0 0 0 0 10
11 0 0 1 0 0 0 0 1 0 0 0 0 0 1 0 0 0 1 0 10 2 19 2 2 17 18 2 11 0 0 1 0 0 0 0 1 0 0 1 0 0 0 0 0 0 0 0 0 10
11 0 4 0 0 0 0 0 0 0 0 0 1 0 0 0 0 0 0 0 10 2 2 2 2 19 2 2 11 0 0 0 0 0 0 4 0 0 0 0 0 0 0 4 0 0 0 0 0 10
11 1 0 0 0 0 0 0 0 0 0 0 0 0 0 0 0 1 0 0 8 7 7 7 7 7 7 7 9 0 1 0 0 0 0 0 1 0 0 0 0 0 0 0 0 1 0 0 0 10
11 0 0 1 0 0 0 0 1 0 0 0 0 0 0 1 0 0 0 0 0 0 0 0 0 0 0 0 0 0 0 0 0 0 0 0 0 0 0 0 1 0 0 0 1 0 0 0 0 10
11 1 0 0 0 4 0 0 0 0 1 0 0 0 0 0 1 0 0 0 0 0 0 0 0 0 0 0 0 0 0 4 0 0 0 0 0 0 0 0 0 0 0 0 0 0 0 0 0 10
11 0 0 0 0 0 0 0 0 0 0 0 0 0 0 0 0 0 0 1 0 0 0 0 0 1 0 0 0 0 0 0 0 0 1 0 4 0 0 0 0 0 0 0 0 0 0 0 0 10
11 0 0 0 0 0 0 0 0 0 0 0 0 0 0 0 0 0 0 0 0 0 0 0 0 0 0 0 0 0 0 0 0 0 0 0 0 0 0 0 1 0 0 0 4 0 0 0 0 10
11 0 0 1 0 0 0 0 0 0 1 0 0 0 0 0 0 0 0 0 0 0 1 0 0 0 0 0 0 0 0 0 0 0 4 0 0 0 0 0 0 0 0 0 0 0 0 0 0 10
11 0 0 0 0 0 0 0 0 0 0 0 0 0 0 0 0 0 0 0 0 0 0 0 0 0 0 0 0 0 0 0 0 0 0 0 0 0 0 0 0 0 0 0 0 0 0 0 0 10
11 0 0 0 0 0 0 4 0 0 0 0 0 0 1 0 0 0 0 0 0 0 0 0 0 4 0 0 0 0 1 0 0 0 0 0 1 0 0 0 4 0 0 1 0 0 0 0 0 10
11 0 0 0 1 0 0 0 0 0 0 0 0 0 0 0 0 0 0 0 0 0 0 0 0 0 0 0 0 0 0 0 0 0 0 0 0 0 0 0 0 0 0 0 0 0 0 0 0 10
11 1 0 0 0 0 0 0 0 1 0 0 0 0 0 0 0 0 0 0 0 0 0 0 0 0 0 0 0 1 0 0 0 0 0 0 0 0 0 0 0 0 0 0 1 0 0 0 0 10
11 0 0 0 0 0 0 0 0 0 0 0 0 0 0 0 0 0 0 0 0 0 0 0 0 0 0 0 0 0 0 0 0 0 0 0 0 1 0 0 0 0 0 0 0 0 1 0 0 10
11 0 0 0 0 0 0 0 0 0 0 0 0 0 0 0 0 0 0 0 0 0 0 0 0 0 0 0 0 0 0 0 0 0 0 0 0 0 0 0 0 0 0 0 0 0 0 0 0 10
11 4 4 4 4 4 4 4 4 4 4 4 4 4 4 4 4 4 4 4 4 4 4 4 0 0 0 4 4 4 4 4 4 4 4 4 4 4 4 4 4 4 4 4 4 4 4 4 4 10
11 4 4 4 4 4 4 4 4 4 4 4 4 4 4 4 4 4 4 4 4 4 4 4 0 0 0 4 4 4 4 4 4 4 4 4 4 4 4 4 4 4 4 4 4 4 4 4 4 10
11 4 4 4 4 4 4 4 0 0 1 4 4 4 4 4 4 4 4 4 4 4 4 4 0 0 0 4 4 4 4 4 4 4 4 4 4 4 4 0 0 0 4 4 4 4 4 4 4 10
11 4 4 4 4 4 4 4 0 1 0 4 4 4 4 4 4 4 4 4 4 4 4 4 0 0 0 4 4 4 4 4 4 4 4 4 4 4 4 0 1 0 4 4 4 4 4 4 4 10
11 4 4 4 4 4 4 4 0 0 0 0 0 0 1 0 0 0 0 0 0 0 0 0 0 1 0 0 0 0 0 0 0 1 0 4 4 4 4 0 0 0 4 4 4 4 4 4 4 10
11 4 4 4 4 4 4 4 0 0 0 0 0 1 0 0 0 0 0 0 1 0 0 0 0 0 0 0 0 0 1 0 0 0 0 4 4 4 4 0 0 1 4 4 4 4 4 4 4 10
11 4 4 4 4 4 4 4 0 0 0 4 4 0 0 0 4 4 4 4 4 4 4 4 4 4 4 4 4 4 4 4 0 0 0 4 4 4 4 1 0 0 4 4 4 4 4 4 4 10
22 12 12 12 12 14 4 4 0 0 0 4 4 0 0 0 4 4 4 4 4 4 4 4 4 4 4 4 4 4 4 4 1 0 0 4 4 4 4 0 0 0 4 4 4 4 4 4 4 10
2 19 2 19 2 11 4 4 0 0 0 4 4 0 0 0 4 4 4 4 4 4 4 4 4 4 4 4 4 4 4 4 0 0 0 4 4 4 4 0 1 0 4 4 4 4 4 4 4 10
2 2 2 2 2 11 4 4 29 31 30 4 4 0 0 0 4 4 4 4 4 4 4 4 4 4 4 4 4 4 4 4 0 1 0 0 0 0 1 0 0 0 4 4 4 4 4 4 4 10
2 19 2 2 2 35 31 31 33 6 28 4 4 4 4 4 4 4 4 4 4 4 4 4 4 4 4 4 4 4 4 4 0 0 1 1 0 0 0 0 0 0 4 4 4 4 4 4 4 10
2 2 19 2 2 6 6 6 6 6 28 4 4 4 4 4 4 4 4 4 4 4 4 4 4 4 4 4 4 4 4 4 4 4 4 4 4 4 4 4 4 4 4 4 4 4 4 4 4 10
2 2 2 19 2 2 2 2 2 2 11 4 4 4 4 4 4 4 4 4 4 4 4 4 4 4 4 4 4 4 4 4 4 4 4 4 4 4 4 4 4 4 4 4 4 4 4 4 4 10
2 19 2 2 2 2 19 2 19 2 11 4 4 4 4 4 4 4 4 4 4 4 4 4 4 4 4 4 4 4 4 4 4 4 4 4 4 4 4 4 4 4 4 4 4 4 4 4 4 10
2 2 2 2 2 2 2 2 2 2 22 12 12 12 12 12 12 12 12 12 12 12 12 12 12 12 12 12 12 12 12 12 12 12 12 12 12 12 12 12 12 12 12 12 12 12 12 12 12 23
